5 5
. . E . #
# . . . .
. # # # .
. # # # .
. . . . S